MMMMMMMMMMMMMMM
MP  M MM  MMMMM
M   M MM     MM
M           MMM
MMMMMMMM    MMM
M M       M  MM
M        M MMMM
MMMMM        MM
M         MMMMM
MMMM   MM MMMMM
MM   M       GM
MMM M   M MMMMM
MMM     MMMMMMM
M           MMM
MMMMMMMMMMMMMMM