MMMMMMMMMMMMMMM
MP  M MMMMMMMMM
M M M MM      M
M M   MM MMMM M
MMM M MM    M M
M M M    MM  MM
M   M MM M MM M
MMMMM         M
M     MM  MMMMM
MMMM MMMM MMMMM
MM   MM       M
M  MM   M MMMGM
MMM   M MMMMMMM
M   MMM     MMM
MMMMMMMMMMMMMMM