MMMMMMMMMMMMMMM
M   M MMMMMMMMM
M M M MM      M
M M   MM    M M
MMM M MM    M M
M M M    MM  MM
M   M MM M MM M
MMMMM         M
M     MM  MMMMM
MMMM MMMM MMMMM
MM   MM       M
M  MM   M MMM M
MMM   M MMMMMMM
M   MMM     MMM
MMMMMMMMMMMMMMM